5,1,2
S..XX.....
XXX....X..
....X.....
.X..X....G
..........
..........
..........
..........
..........
..........
