10,1,2
S..X......
.XX.X.XX..
.....X..X.
X.XX.X....
X...X.XX..
X.X.X.X.X.
X.X.X.X.X.
...X...X..
...X.....G
...X......
