4,2,3
S.X.X.X...
..X...X.X.
X.X.X.X.X.
.X.....X..
.X.XXX.X.X
.X...X.X.G
.X.X.X.X.X
.X.X.X.X.X
.X.......X
X.X.X.X.X.
