7,1,1
S.X.X.X...
.X.X.X.X..
.X.....X..
.......X..
.X.XX.XX..
XXXXXXXX..
X.X.X.....
XX.G......
..XX......
..........
