6,0,2
S.........
.XXX......
...X......
...X.....G
..........
..........
..........
..........
..........
..........
